111111111
1C1C1ECC1
1C1C111C1
1CCNPCCC1
111C1C111
111N1CCN1
111111111