11111111111111111111111111111111111111111111111111
1P1C1CC1000010110110101000100110001011000110001101
1CCCCCCCCCC000010100001110101111101001101111011101
111011111C1111010111011000000101000011001010010001
101000111C1000000100011111110101111001101011011101
101010101C1111110111010101010000001100101011010101
10111CCCCCCCCCCCCCCCC10101011101100001100011010001
10111111111111010111C00001001101111100110110000111
10100111110111111111C11101011111011110010011011111
10001100000101101000C00001011010010110110110001101
10100001110001000010C01100001011010100010000100001
11101101100100010111C11111101011010110110111111101
11111111111111011101C00000000000000010000011111111
10011010000000011101C01000000111001101111110001011
10011011000011111111C11101010010011000000011011111
11010001111110000000C10001011000111011111110010001
10011101000100101010C11011001101100011111111000101
11000001110110111011C10010011101001000000011111111
11111101100000001111C11111010001101101101000000111
10110001101101101101C10101111101101000101011111101
10000100001101101000C10101101101111110111000011101
10110101011000111111C00000000000001100011010110001
11100101011111110111C10111011011100111011110000101
11001111110110100000C11110010011001100000110101111
10011100000000001010C01011111001101001010011100001
10110101101110101010C00000000011111101011000110101
10000111111000111111C10110110110000001011011100111
10111110000010011000C00100110011010111011000110001
10000011111010111111C11110010110011110011011111011
10110111011010001111C11000110011011000110000011001
10110110000011011000C00010110110001010011011001011
10010110101001110010C01010110110111111010001011001
10111111111100011111C11010111110010111110111011101
10100011000001010000C10010011000110010110011000101
10001011111011011111C00110111101111000000111010101
10101110100011111100C10010101001001111110101111111
11101110111010000001C11011101111100000000000001001
10001000000010101101C11001001011001111101010100011
11011011101011111111C11100011000011100001010111001
10001111001011000000C01110111110110001011011100011
11011000011010010101C11000001100011011110001111001
11001110111111111111C11101011001111110100100011011
10011110001100000000C01101001101110100001101110001
10110000100110111101C11101100111000001101100011011
11111010101111100001C11001001100011101001101011001
10000010100001111101C01101101111111111100101011101
11010111111111011101CCCCCCCCCCCCCCCCCCCCCCCCCCCCC1
100100001100000000000011000011000001010110011011E1
11111111111111111111111111111111111111111111111111