11111111
1P0000N1
10000001
1C0000E1
11111111