11111111
1P0000C1
110000N1
1C0000E1
11111111