11111111111111111111111111111111111111111111111111
1P101001000010110110101000100110001011000110001101
10001100011000010100001110101111101001101111011101
11101111111111010111011000000101000011001010010001
10100011101000000100011111110101111001101011011101
10101010101111110111010101010000001100101011010101
10111000000000000000010101011101100001100011010001
10111111111111010111000001001101111100110110000111
10100111110111111111111101011111011110010011011111
10001100000101101000000001011010010110110110001101
10100001110001000010101100001011010100010000100001
11101101100100010111111111101011010110110111111101
11111111111111011101000000000000000010000011111111
10011010000000011101101111111101101000101000100001
11001011111010110000001000000111001101111110001011
10011011000011111111011101010010011000000011011111
11010001111110000000010001011000111011111110010001
10011101000100101010111011001101100011111111000101
11000001110110111011110010011101001000000011111111
11111101100000001111011111010001101101101000000111
10110001101101101101010101111101101000101011111101
10000100001101101000010101101101111110111000011101
10110101011000111111000000000000001100011010110001
11100101011111110111110111011011100111011110000101
11001111110110100000111110010011001100000110101111
10011100000000001010001011111001101001010011100001
10110101101110101010100000000011111101011000110101
10000111111000111111110110110110000001011011100111
10111110000010011000000100110011010111011000110001
10000011111010111111011110010110011110011011111011
10110111011010001111111000110011011000110000011001
10110110000011011000100010110110001010011011001011
10010110101001110010001010110110111111010001011001
10111111111100011111111010111110010111110111011101
10100011000001010000010010011000110010110011000101
10001011111011011111000110111101111000000111010101
10101110100011111100010010101001001111110101111111
11101110111010000001011011101111100000000000001001
10001000000010101101011001001011001111101010100011
11011011101011111111011100011000011100001010111001
10001111001011000000001110111110110001011011100011
11011000011010010101011000001100011011110001111001
11001110111111111111011101011001111110100100011011
10011110001100000000001101001101110100001101110001
10110000100110111101011101100111000001101100011011
11111010101111100001011001001100011101001101011001
10000010100001111101001101101111111111100101011101
110101111111110111011111111001111100000011010011C1
100100001100000000000011000011000001010110011011E1
11111111111111111111111111111111111111111111111111