111111111
100E00011
100000011
100000011
100000011
100000011
100000011
1000000P1
111111111